##############
#    #     ###
#    # *  *  #
#    #*####  #
#      H ##  #
#    # #  * ##
###### ##* * #
### *  * * * #
###    #     #
##############

##############
#XX  #     ###
#XX  #       #
#XX  # ####  #
#XX      ##  #
#XX  # #    ##
###### ##    #
###          #
###    #     #
##############
