##################
#       ##     H##
# ##### ## *#* ###
# ##### ## *  *###
#       ###* * ###
########## * # ###
#       ## *  *  #
##        *  *   #
#       ##########
##################

##################
#       ##      ##
# ##### ##  #  ###
# ##### ##     ###
#       ###    ###
##########   # ###
#XXXX   ##       #
##XXX            #
#XXXX   ##########
##################
