#################
#########   #####
######### #*##  #
#########     * #
######### ###   #
#      ## *  *###
#        * ** ###
#      ##*  * H##
#########  *  ###
######### * *  ##
########### ## ##
###########    ##
#################

#################
#########   #####
######### # ##  #
#########       #
######### ###   #
#XXXX  ##     ###
#XXXX         ###
#XXXX  ##      ##
#########     ###
#########      ##
########### ## ##
###########    ##
#################
