#######
#  H  #
#     #
#  *  #
#     #
#     #
#######

#######
#     #
#     #
#     #
#     #
#  X  #
#######
