##########
##    ####
## *  * ##
###*# # ##
### # # ##
#    H   #
#   ##   #
##########

##########
##    ####
##      ##
### # # ##
### # # ##
# X X X  #
#   ##   #
##########
