#################
##     ######   #
##      H       #
#  ########## ###
# *  *   *     ##
#  #   #   #   ##
#################

#################
##     ######   #
##        XXX   #
#  ########## ###
#              ##
#  #   #   #   ##
#################
