##########
#   ######
#   ######
#**** * H#
#        #
##########

##########
#   ######
#   ######
#        #
#XXXXX   #
##########
