########
##  ####
##  ####
##   * #
## **H #
#   ####
#   ####
########

########
##  ####
##  ####
## XXX #
##     #
#   ####
#   ####
########
