########
###  ###
###    #
#H***  #
#   #  #
###   ##
########

########
###  ###
### X  #
#      #
#   #X #
###X  ##
########
