#########
#   #####
#   * ###
##  # * #
##  # *H#
###   * #
###  ####
#########

#########
#   #####
#  X  ###
## X#   #
## X#   #
###X    #
###  ####
#########
