######
#  ###
#H  ##
#  *##
# ** #
#    #
######

######
#  ###
# X ##
#XX ##
#    #
#    #
######
